1111111111111
1CE10000000C1
1X00011111001
1P0C11E000X01
1111111111111