1111111111111
1CE10000000C1
1000011111001
1P0C11E000001
1111111111111