1111111111111111111
1CE10000000C1111111
1000011111001111111
1P0C11E000X011111
1111111111111