11111111111111111111111
1C0100P0000C0000000X001
1000011100000000000C101
100C11C0000000C000001E1
11111111111111111111111