1111111111111111
1111CCCCCCE1CCC1
11C001111C0111C1
1CCC1111PCX000C1
1111111111111111