111111111111111111
111100C0000C000011
1E0001111C001110C1
1C0C1111P00000CX11
111111111111111111