1111111111111
1          P1
1           1
1           1
1111111111111